FFFFFFFF
........
........
........
........
........
........
........
........
........
WWWWWWWW
WWWWWWWW
........
........
........
RRRRRRRR
RRRRRRRR
RRRRRRRR
........
........
WWWWWWWL
LWWWWWWW
........
........
VRRRRRRR
RRRRRRRV
........
........
........
.1.2.3.4