.1.2.3.4
........
........
........
RRRRRRRV
VTTTTTTT
........
........
LWWWWWWW
WWWWWWWL
........
........
RRRRRRRR
RRRRRRRR
TTTTTTTT
........
........
........
WWWWWWWW
WWWWWWWW
........
........
........
........
........
........
........
........
........
FFFFFFFF