.1.2.3.4
........
........
........
RRRRRRRV
PTTTTTTT
........
........
LWWWAWWW
WWWWWWWL
........
........
RRRCRRRR
RRRRRRRR
TTTTTTTT
........
........
........
WWWWWWWW
WWWWWWWW
........
........
........
........
........
........
........
........
........
FFFFFFFF